
Triangles

         #
         #
        ###
        #4#
       ##.##
       #5.5#
      ##.@.##
      #6...6#
     ##.....##
     #6533356#
    #####3#####
    #4#3...3#4#
   ##5##.5.##5##
   #...#...#...#
  ##...##.##...##
  #23...656...32#
 ##11231###13211##
 #522112.4.211225#
###################

Squares

################
#64531566513546#
#4@..643346...4#
#5.##3####3##.5#
#3.#..3663..#.3#
#163..1..1..361#
#54#31#..#13#45#
#63#6..22..6#36#
#63#6..22..6#36#
#54#31#..#13#45#
#163..1..1..361#
#3.#..3663..#.3#
#5.##3####3##.5#
#4...643346...4#
#64531566513546#
################

Parallelograms

#############      
 #61235241535#     
  #54342...126#    
   #4511.@.5435#   
    #155...12542#  
     #23354251326# 
      #1#2#3#######
#######3#2#1#      
 #62315245332#     
  #24521...551#    
   #5345...1154#   
    #621...24345#  
     #53514253216# 
      #############

Grid

#################
#525452545254525#
#3.1.3.1.3.1.3.1#
#525452545254525#
#3.1.3.1.3.1.3.1#
#525452545254525#
#3.1.3@1.3.1.3.1#
#525452545254525#
#3.1.3.1.3.1.3.1#
#525452545254525#
#3.1.3.1.3.1.3.1#
#525452545254525#
#3.1.3.1.3.1.3.1#
#525452545254525#
#3.1.3.1.3.1.3.1#
#525452545254525#
#3.1.3.1.3.1.3.1#
#525452545254525#
#3.1.3.1.3.1.3.1#
#525452545254525#
#################

Narrow Passages

#######     #######
#14.53#     #35.15#
#43.11#     #14.31#
#.....#######.....#
#51.@..31415....45#
#31...#######...13#
####.##     ##.####
   #3#       #5#   
   #1#       #1#   
   #4#       #4#   
   #1#       #1#   
   #5#       #3#   
####.##     ##.####
#31...#######...13#
#54....51413....15#
#.....#######.....#
#13.41#     #11.34#
#51.53#     #35.41#
#######     #######

Wide Holes

#################
#534123415234165#
#143654562535241#
#32##51426233654#
#4#  #5124112254#
#3#  #651###5123#
#12##234#   #545#
#6534363#   #613#
#123..32#   #453#
#41.@..42###6253#
#51....612361254#
#642..6125346142#
#612436512634126#
#5235###5162##24#
#161#   #54#  #5#
#134#   #23#  #2#
#341#   #241##23#
#1251###61541623#
#612546124616241#
#615451416541216#
#154365423123456#
#################

Concentric

    ########    
  ###666666###  
 ##6655555566## 
 #665444444566# 
##654433334456##
#65443222234456#
#65432211223456#
#654321.@123456#
#654321..123456#
#65432211223456#
#65443222234456#
##654433334456##
 #665444444566# 
 ##6655555566## 
  ###666666###  
    ########    

Semipermeable

################
#1#3456.234#612#
#612345#1.34561#
#5.#2345612.#56#
#456.234#6123.5#
#345#1.345612#4#
#2345612.#56123#
#.234#6123.561##
##1.345..2#4.61#
#5612.#@.12345.#
#4#61....61#345#
#3456..#..61234#
#2.#5612.45.#23#
#123.561#3456.2#
#612#4.612345#1#
#5612345.#23456#
#.561#3456.234##
##4.612345#1.34#
#2345.#2345612.#
#1#3456.234#612#
#612345#1.34561#
################

Bubbles

   ###          
  #453#         
 #51431#        
#6153612#       
#16532.4#       
#53...12#       
 #23125####     
  #15435152##   
   ###6152454#  
    #614534235# 
    #253416123# 
   #615243154.5#
   #65123126..4#
   #166153...14#
    #153..@.46# 
    #34....425# 
     #6512463#  
      ##423##   
        ###     

Boxed Diamonds

#############
#44444144444#
#46661116664#
#46511211564#
#46112221164#
#4112...2114#
#1122.@.2211#
#4112...2114#
#46112221164#
#46511211564#
#46661116664#
#44444144444#
#############

Tribute

    #####         
    #664#         
    #6.4#         
  ###..4##        
  #.33555#        
###.#3##.#  ######
#.2.#.##.####..12#
#22.111........34#
####.###.#@.#..56#
   #.....#########
   #######        

Finale

    #####          # 
 ## #231#         ## 
#12##231#        #6# 
#5231231#       #23# 
#12##231#      #231# 
 ## #231#     #2312# 
    ###63### #23123# 
     ##12331#23##### 
    #123123123#      
   #12312332312#     
   #13123131322#     
  #3231231313221#    
  #13133...32312#####
  #31331@4.321235112#
  #33122...32112###1#
  #3213123322132# #2#
   #32133221233#  #3#
   #32312213212# ##2#
    #321231232#  #..#
     ##33123##   #4.#
       #####     ####

